London, 1895. A heavy fog presses against the windows of 221B Baker Street. You have found a bomb in your safe, planted by Moriarty.

OBJECTIVE: Defuse the bomb.
1. Explore the apartment (Kitchen, Bedroom, Lab).
2. Ignore the distractions.
3. Find the tools and the clue.
4. Act before the timer runs out.

Sherlock Holmes: The Final Problem
An Interactive Fiction by Student
Release 1 / Serial number 260113 / Inform 7 v10.1.2 / D

Hallway
A dimly lit corridor in 221B Baker Street. The wallpaper is peeling slightly. To the NORTH is the Bedroom. To the SOUTH is the Office. To the EAST is the Kitchen.

>e
Office
The main study. Dr. Watson is standing here nervously. A locked safe is in the corner.

Your loyal assistant, Dr. Watson.

You can also see a safe (closed) and a silver key here.

>talk to watson
"Holmes, you must analyze the liquid in the Laboratory first!"

>n
You can't go that way.

>s
You can't go that way.

>w
Laboratory
Sherlock's home lab. Smells of sulfur. The Office is to the EAST.

A bottle of reagent.

You can also see a test tube here.

>mix chemical with tube
You carefully pour the blue chemical into the tube. It turns BRIGHT PURPLE! It is arsenic! You have the proof.

>e
Office
The main study. Dr. Watson is standing here nervously. A locked safe is in the corner.

Your loyal assistant, Dr. Watson.

You can also see a safe (closed) and a silver key here.

>talk to watson
"Brilliant, Holmes! You found the toxin! Open the safe now!"

>open safe
It seems to be locked.

>take key
Taken.

>unlock safe with key
You unlock the safe.

>open safe
You open the safe, revealing an evidence.

>take evidence
Taken.

    *** ELEMENTARY! You analyzed the poison and found the confession. Case closed. ***

Would you like to RESTART, RESTORE a saved game, QUIT or UNDO the last command?

* * *

>east
Kitchen
Mrs. Hudson's domain, currently empty. There is a smell of cold tea and toast. A cupboard stands against the wall.

A cup of Earl Grey, half finished.

You can also see a cupboard (closed) here.

>open cupboard
You open the cupboard, revealing a butter knife.

>take knife
Taken.

>take cup
Taken.

>examine cup
You see nothing special about the cup of tea.

>drink cup
It is stone cold and bitter. You regret that.

>west
Hallway
A dimly lit corridor in 221B Baker Street. The wallpaper is peeling slightly. To the NORTH is the Bedroom. To the SOUTH is the Office. To the EAST is the Kitchen.

>examine wallpaper
You can't see any such thing.

>north
Bedroom
A messy personal room. A bed stands unmade. A heavy coat hangs on the chair. A violin case lies open on the floor.

Holmes's famous Stradivarius violin.

Heavy-duty wire cutters.

You can also see a coat (in which is a note) here.

>take violin
Taken.

>play violin
You play a quick, frantic melody to clear your mind. Watson yells from the other room: "Not now, Holmes!"

From the street below, you hear a carriage pass by. Time is running out.

>take cutters
Taken.

>take coat
Taken.

>examine note
You recognize the handwriting instantly. It says: "The Royal BLOOD is blue. Remember that when you make your choice." (Hint: Cut the BLUE wire).

>south
Hallway
A dimly lit corridor in 221B Baker Street. The wallpaper is peeling slightly. To the NORTH is the Bedroom. To the SOUTH is the Office. To the EAST is the Kitchen.

>south
Office
Sherlock's chaotic study. Papers are scattered everywhere. The air smells of stale tobacco. To the WEST is the Laboratory. A massive iron safe stands in the corner.

Dr. Watson is pacing back and forth, looking pale.

A book titled "The Dynamics of an Asteroid".

You can also see a safe (closed) here.

>take book
Taken.

>read book
Written by Professor Moriarty. Pure mathematics. It contains no clues about bombs.

>open safe
It seems to be locked.

>south
You can't go that way.

>north
Hallway
A dimly lit corridor in 221B Baker Street. The wallpaper is peeling slightly. To the NORTH is the Bedroom. To the SOUTH is the Office. To the EAST is the Kitchen.

>north
Bedroom
A messy personal room. A bed stands unmade. A heavy coat hangs on the chair. A violin case lies open on the floor.

>open case
You can't see any such thing.

>examine case
You can't see any such thing.

>make bed
That's not a verb I recognise.

>north
You can't go that way.

>south
Hallway
A dimly lit corridor in 221B Baker Street. The wallpaper is peeling slightly. To the NORTH is the Bedroom. To the SOUTH is the Office. To the EAST is the Kitchen.

>west
You can't go that way.

>east
Kitchen
Mrs. Hudson's domain, currently empty. There is a smell of cold tea and toast. A cupboard stands against the wall.

You can see a cupboard (empty) here.

>west
Hallway
A dimly lit corridor in 221B Baker Street. The wallpaper is peeling slightly. To the NORTH is the Bedroom. To the SOUTH is the Office. To the EAST is the Kitchen.

>look
Hallway
A dimly lit corridor in 221B Baker Street. The wallpaper is peeling slightly. To the NORTH is the Bedroom. To the SOUTH is the Office. To the EAST is the Kitchen.

>south
Office
Sherlock's chaotic study. Papers are scattered everywhere. The air smells of stale tobacco. To the WEST is the Laboratory. A massive iron safe stands in the corner.

Dr. Watson is pacing back and forth, looking pale.

You can also see a safe (closed) here.

>unlock safe
What do you want to unlock the safe with?

>key
You can't see any such thing.

>south
You can't go that way.

>west
Laboratory
A wooden table filled with bubbling retorts, bunsen burners, and strange glass jars. A bowl of acid sits dangerously on the edge.

Iron tongs (stained with chemicals).

You can also see a golden key here.

Dr. Watson shouts: "Holmes! The ticking is getting deafening!"

>take tongs
Taken.

>take key
Using the tongs, you carefully fish the key out of the hissing acid.

>east
Office
Sherlock's chaotic study. Papers are scattered everywhere. The air smells of stale tobacco. To the WEST is the Laboratory. A massive iron safe stands in the corner.

Dr. Watson is pacing back and forth, looking pale.

You can also see a safe (closed) here.

>unlock safe
What do you want to unlock the safe with?

>key
You unlock the safe.

>open safe
You open the safe, revealing a time bomb, a red wire and a blue wire.

>cut blue wire
Cutting it up would achieve little.

>cut red wire
Cutting it up would achieve little.

>cut blue
Cutting it up would achieve little.

>cut wire
(the wire cutters)
Cutting it up would achieve little.

>whz
That's not a verb I recognise.

* * *

>n
Bedroom
Your sleeping quarters. A coat is hanging here.

You can see a coat (in which is a magnifying glass) here.

>open coat
That's already open.

>take glass
Taken.

>s
Office
Sherlock's office at 221B Baker Street. It is messy. A safe is here. The Bedroom is to the NORTH.

You can see a safe (closed) and a small key here.

>take key
Using the magnifying glass, you find a microscopic key on the floor! You take it.

>open safe
It seems to be locked.

>use key
That's not a verb I recognise.

>unlock safe with key
You unlock the safe.

>open safe
You open the safe, revealing a secret letter.

>take letter
Taken.

    *** You found the letter! Case closed. Excellent work, Holmes! ***

Would you like to RESTART, RESTORE a saved game, QUIT or UNDO the last command?

* * *

>north
Bedroom
A messy personal room. A bed stands unmade. A heavy coat hangs on the chair. A violin case lies open on the floor.

Holmes's famous Stradivarius violin.

Heavy-duty wire cutters.

You can also see a coat (in which is a note) here.

>take coat
Taken.

>examine note
You recognize the handwriting instantly. It says: "The Royal BLOOD is blue. Remember that when you make your choice."

>take cutters
Taken.

>south
Hallway
A dimly lit corridor in 221B Baker Street. The wallpaper is peeling slightly. To the NORTH is the Bedroom. To the SOUTH is the Office. To the EAST is the Kitchen.

* * *

>south
Office
Sherlock's chaotic study. Papers are scattered everywhere. The air smells of stale tobacco. To the WEST is the Laboratory. A massive iron safe stands in the corner.

Dr. Watson is pacing back and forth, looking pale.

A book titled "The Dynamics of an Asteroid".

You can also see a safe (closed) here.

>west
Laboratory
A wooden table filled with bubbling retorts, bunsen burners, and strange glass jars. A bowl of acid sits dangerously on the edge.

Iron tongs (stained with chemicals).

You can also see a golden key here.

>take tongs
Taken.

* * *

>take key
Using the tongs, you carefully fish the key out of the hissing acid.

>east
Office
Sherlock's chaotic study. Papers are scattered everywhere. The air smells of stale tobacco. To the WEST is the Laboratory. A massive iron safe stands in the corner.

Dr. Watson is pacing back and forth, looking pale.

A book titled "The Dynamics of an Asteroid".

You can also see a safe (closed) here.

From the street below, you hear a carriage pass by. Time is running out.

>open safe
It seems to be locked.

>unlock safe
What do you want to unlock the safe with?

* * *

>open safe
You open the safe, revealing a time bomb, a red wire and a blue wire.

>cut red wire
Cutting it up would achieve little.

>cut blue wire
Cutting it up would achieve little.

>wirecut red wire
That's not a verb I recognise.

* * *

>pogledaj
Svlacionica
Nalazis se u svlacionici. Zrak je tezak od napetosti i mirisa mentola. Trener je upravo zavrsio govor. Tvoja oprema je na klupi, a izlaz prema terenu je na sjeveru.

You can see a drvena klupa (on which are a dres s brojem deset and a kopacke) here.

>obuci opremu
You can't see any such thing.

>obuci oprema
You can't see any such thing.

>uzmi oprema
You can't see any such thing.

>n
Ne mozes na teren bez dresa! Sudac te nece pustiti.

>uzmi dres
Taken.

>n
Ne mozes na teren bez dresa! Sudac te nece pustiti.

>obuci dres
You put on the dres s brojem deset.

>n
Jesi li lud? Ne mozes igrati bos!

>obuci kopacke
(first taking the kopacke)
You put on the kopacke.

>n
Tunel
Mracan betonski tunel. Cujes huk navijaca koji dolazi sa sjevera, s glavnog terena.

>pogledaj
Tunel
Mracan betonski tunel. Cujes huk navijaca koji dolazi sa sjevera, s glavnog terena.

>n
Teren
Zeleni travnjak pod reflektorima. Stadion je pun. Sudac gleda na sat. Ovo je tvoja prilika.

You can see a nogometna lopta and a protivnicki gol (empty) here.

>pucaj loptu
You can't see any such thing.

>pogledaj
Teren
Zeleni travnjak pod reflektorima. Stadion je pun. Sudac gleda na sat. Ovo je tvoja prilika.

You can see a nogometna lopta and a protivnicki gol (empty) here.

* * *

>sout
That's not a verb I recognise.

>south
Office
Sherlock's chaotic study. Papers are scattered everywhere. The air smells of stale tobacco. To the WEST is the Laboratory. A massive iron safe stands in the corner.

Dr. Watson is pacing back and forth, looking pale.

A book titled "The Dynamics of an Asteroid".

You can also see a safe (closed) here.

>north
Hallway
A dimly lit corridor in 221B Baker Street. The wallpaper is peeling slightly. To the NORTH is the Bedroom. To the SOUTH is the Office. To the EAST is the Kitchen.

>south
Office
Sherlock's chaotic study. Papers are scattered everywhere. The air smells of stale tobacco. To the WEST is the Laboratory. A massive iron safe stands in the corner.

Dr. Watson is pacing back and forth, looking pale.

A book titled "The Dynamics of an Asteroid".

You can also see a safe (closed) here.

>north
Hallway
A dimly lit corridor in 221B Baker Street. The wallpaper is peeling slightly. To the NORTH is the Bedroom. To the SOUTH is the Office. To the EAST is the Kitchen.

From the street below, you hear a carriage pass by. Time is running out.

* * *

>south
Office
Sherlock's chaotic study. Papers are scattered everywhere. The air smells of stale tobacco. To the WEST is the Laboratory. A massive iron safe stands in the corner.

Dr. Watson is pacing back and forth, looking pale.

A book titled "The Dynamics of an Asteroid".

You can also see a safe (closed) here.

* * *

>north
Hallway
A dimly lit corridor in 221B Baker Street. The wallpaper is peeling slightly. To the NORTH is the Bedroom. To the SOUTH is the Office. To the EAST is the Kitchen.

>north
Bedroom
A messy personal room. A bed stands unmade. A heavy coat hangs on the chair. A violin case lies open on the floor.

Holmes's famous Stradivarius violin.

Heavy-duty wire cutters.

You can also see a coat (in which is a note) here.

>take cutters
Taken.

>north
You can't go that way.

>west
You can't go that way.

>sout
That's not a verb I recognise.

>south
Hallway
A dimly lit corridor in 221B Baker Street. The wallpaper is peeling slightly. To the NORTH is the Bedroom. To the SOUTH is the Office. To the EAST is the Kitchen.

* * *

>west
Laboratory
A wooden table filled with bubbling retorts, bunsen burners, and strange glass jars. A bowl of acid sits dangerously on the edge.

Iron tongs (stained with chemicals).

You can also see a golden key here.

>take tongs
Taken.

From the street below, you hear a carriage pass by. Time is running out.

>take key
Using the tongs, you carefully fish the key out of the hissing acid.

>east
Office
Sherlock's chaotic study. Papers are scattered everywhere. The air smells of stale tobacco. To the WEST is the Laboratory. A massive iron safe stands in the corner.

Dr. Watson is pacing back and forth, looking pale.

A book titled "The Dynamics of an Asteroid".

You can also see a safe (closed) here.

>unlock safe
What do you want to unlock the safe with?

* * *

>open safe
You open the safe, revealing a time bomb, a red wire and a blue wire.

>cut blue wire
With steady hands, you sever the blue wire. The clockwork mechanism winds down with a groan. Silence falls over Baker Street.

    *** ELEMENTARY! You have saved the day once again. ***

Would you like to RESTART, RESTORE a saved game, QUIT or UNDO the last command?

* * *

>east
Office
Sherlock's chaotic study. Papers are scattered everywhere. The air smells of stale tobacco. To the WEST is the Laboratory. A massive iron safe stands in the corner.

Dr. Watson is pacing back and forth, looking pale.

A book titled "The Dynamics of an Asteroid".

You can also see a safe (closed) here.

>south
You can't go that way.

* * *

>take cutters
Taken.

>take coat
Taken.

From the street below, you hear a carriage pass by. Time is running out.

>examine note
You recognize the handwriting instantly. It says: "The Royal BLOOD is blue. "

>south
Hallway
A dimly lit corridor in 221B Baker Street. The wallpaper is peeling slightly. To the NORTH is the Bedroom. To the SOUTH is the Office. To the EAST is the Kitchen.

* * *

>south
Office
Sherlock's chaotic study. Papers are scattered everywhere. The air smells of stale tobacco. To the WEST is the Laboratory. A massive iron safe stands in the corner.

Dr. Watson is pacing back and forth, looking pale.

A book titled "The Dynamics of an Asteroid".

You can also see a safe (closed) here.

>unlock safe
What do you want to unlock the safe with?

* * *

>open safe
You open the safe, revealing a time bomb, a red wire and a blue wire.

>cut red wire
You snip the red wire. The ticking stops for a second...

    *** CLICK. BOOM! You chose poorly. The red wire was the trigger. ***

Would you like to RESTART, RESTORE a saved game, QUIT or UNDO the last command?

* * *

>w
Laboratory
A table full of chemicals. A bowl of acid is here.

Iron tongs.

You can also see a golden key here.

>take key
The acid burns! You need tongs to pick that up.

>take tongs
Taken.

>take key
You use the tongs to take the key safely.

>e
Office
Sherlock's study. The Laboratory is to the WEST. The Bedroom is to the NORTH.

You can see a safe (closed) here.

>n
Bedroom
A quiet room. A coat hangs on the chair.

Wire cutters.

You can also see a coat (in which is a note) here.

>open coat
It isn't something you can open.

>take note
Taken.

>open note
It isn't something you can open.

>take wire cutters
You can't see any such thing.

>n
You can't go that way.

>s
Office
Sherlock's study. The Laboratory is to the WEST. The Bedroom is to the NORTH.

You can see a safe (closed) here.

>w
Laboratory
A table full of chemicals. A bowl of acid is here.

>e
Office
Sherlock's study. The Laboratory is to the WEST. The Bedroom is to the NORTH.

You can see a safe (closed) here.

>open safe
It seems to be locked.

* * *

>unlock safe
What do you want to unlock the safe with?

>key
You unlock the safe.

The ticking is getting faster! 5 minutes left!

>open safe
You open the safe, revealing a time bomb, a red wire and a blue wire.

* * *

>cut blue wire
Cutting it up would achieve little.

>cut
What do you want to cut?

>wire
Which do you mean, the red wire or the blue wire?

>red
Cutting it up would achieve little.

>w
Laboratory
A table full of chemicals. A bowl of acid is here.

    *** BOOM! The bomb exploded. ***

Would you like to RESTART, RESTORE a saved game, QUIT or UNDO the last command?

>restart
Defuse the bomb in the safe! Find the key in the acid (use tools) and cut the right wire.

Sherlock Holmes: The Bomb Case
An Interactive Fiction by Student
Release 1 / Serial number 260101 / Inform 7 v10.1.2 / D

Office
Sherlock's study. The Laboratory is to the WEST. The Bedroom is to the NORTH.

You can see a safe (closed) here.

>w
Laboratory
A table full of chemicals. A bowl of acid is here.

Iron tongs.

You can also see a golden key here.

>take tongs
Taken.

>take golden key
You use the tongs to take the key safely.

>e
Office
Sherlock's study. The Laboratory is to the WEST. The Bedroom is to the NORTH.

You can see a safe (closed) here.

>look
Office
Sherlock's study. The Laboratory is to the WEST. The Bedroom is to the NORTH.

You can see a safe (closed) here.

>n
Bedroom
A quiet room. A coat hangs on the chair.

Wire cutters.

You can also see a coat (in which is a note) here.

>take wire cutters
You can't see any such thing.

>take coat
Taken.

>open coat
It isn't something you can open.

* * *

>take note
Taken.

>e
You can't go that way.

>w
You can't go that way.

>n
You can't go that way.

* * *

>s
Office
Sherlock's study. The Laboratory is to the WEST. The Bedroom is to the NORTH.

You can see a safe (closed) here.

>unlock safe with key
You unlock the safe.

>open safe
You open the safe, revealing a time bomb, a red wire and a blue wire.

The ticking is getting faster! 5 minutes left!

>cut blue wire
Cutting it up would achieve little.

>examine note
You see nothing special about the note.

>look inside coat
The coat is empty.

>read note
You see nothing special about the note.

* * *

>take tongs
Taken.

>take gold key
You can't see any such thing.

>take golden key
You use the tongs to take the key safely.

* * *

>e
Office
Sherlock's study. The Laboratory is to the WEST. The Bedroom is to the NORTH.

You can see a safe (closed) here.

>n
Bedroom
A quiet room. A coat hangs on the chair.

A pair of sharp wire cutters.

You can also see a coat (in which is a note) here.

>take wire cutters
Taken.

>take coat
Taken.

>look inside coat
In the coat is a note.

>take note
Taken.

>examine note
The handwriting matches Moriarty's. It says: "Blue blood saves the Queen." (Hint: Cut the BLUE wire).

>s
Office
Sherlock's study. The Laboratory is to the WEST. The Bedroom is to the NORTH.

You can see a safe (closed) here.

* * *

>unlock safe with key
You unlock the safe.

>open safe
You open the safe, revealing a time bomb, a red wire and a blue wire.

>cut blue wire
SNIP! You cut the blue wire. The timer stops ticking. The silence is wonderful.

    *** You saved London! ***

Would you like to RESTART, RESTORE a saved game, QUIT or UNDO the last command?

* * *

>n
Bedroom
A quiet room. A coat hangs on the chair.

A pair of sharp wire cutters.

You can also see a coat (in which is a note) here.

>take coat
Taken.

>look inside
You see nothing unexpected in that direction.

>look inside coat
In the coat is a note.

>open note
It isn't something you can open.

>examine note
The handwriting matches Moriarty's. It says: "Blue blood saves the Queen."

>s
Office
Sherlock's study. The Laboratory is to the WEST. The Bedroom is to the NORTH.

You can see a safe (closed) here.

>open safe
It seems to be locked.

* * *

>open safe
You open the safe, revealing a time bomb, a red wire and a blue wire.

>cut blue wire
You can't cut wires with your bare hands! You need the wire cutters.

The ticking is getting faster! 5 minutes left!

>cut wire with wire cutters
You can't see any such thing.

>cut blue wire
You can't cut wires with your bare hands! You need the wire cutters.

>w
Laboratory
A table full of chemicals. A bowl of acid is here.

>e
Office
Sherlock's study. The Laboratory is to the WEST. The Bedroom is to the NORTH.

You can see a safe (in which are a time bomb, a red wire and a blue wire) here.

>s
You can't go that way.

>n
Bedroom
A quiet room. A coat hangs on the chair.

A pair of sharp wire cutters.

    *** BOOM! The bomb exploded. ***

Would you like to RESTART, RESTORE a saved game, QUIT or UNDO the last command?